25 20
32 32
138
2
 0  0  0  0  0  0  0  0  0  0  0  0  0  0  0  0  0  0  0  0  0  0  0  0  0
 0  0  0  0  0  0  0  0  0  0  0  1  1  1  1  1  1  1  1  1  1  1  1  0  0
 0  0  0  0  0  0  0  0  0  0  0  1  0  0  0  0  0  0  0  0  0  0  1  1  1
 0  0  0  0  0  0  0  0  0  0  0  1  0  1  1  1  1  1  1  1  0  0  0  0  0
 0  0  0  0  0  0  0  0  0  0  0  1  0  1  1  0  0  0  0  1  0  0  0  1  1
 0  0  0  0  0  0  1  1  1  1  1  1  0  0  1  0  0  0  0  1  1  1  1  1  0
 0  0  0  0  0  0  1 12  1  1  0  0  0  0  1  1  0  0  0  0  0  0  0  0  0
 1  1  1  1  1  1  1  0  1  1  0  1  1  0  0  0  1  1  1  0  0  0  0  0  0
 1  0  0  0  0  0  0  0  0  0  0  1  0  1  1  0  0  0  1  0  0  0  0  0  0
 1  0  1  1  1  1  1  1  0  0  0  1  1  1  1  0  0  1  1  0  0  0  0  0  0
 1  0  1  0  0  0  0  1  0  0  0  0  0  0  0  0  0  1  0  0  1  1  8  1  1
 1  0  1  0  0  0  0  1  1  1  0  0  0  0  0  0  0  1  1  1  1  0  0  0  1
 1  0  1  0  0  0  0  0  0  1  0  0  0  0  0  0  0  0  0  0  0  0  0  0  1
 1  0  1  0  0  0  0  0  0  1  1  1  1  1  1  1  1  1  1  1  1  0  0  0  1
 1  0  1  1  1  0  0  0  0  0  0  0  0  0  0  0  0  0  0  0  1  1  1  1  1
 1  0  0  0  1  0  0  0  0  0  0  0  0  0  0  0  0  0  0  0  0  0  0  0  0
 1  0  0  0  1  0  0  0  0  0  0  0  0  0  0  0  0  0  0  0  0  0  0  0  0
 1  0  0  0  1  0  0  0  0  0  0  0  0  0  0  0  0  0  0  0  0  0  0  0  0
 1  1  1  1  1  0  0  0  0  0  0  0  0  0  0  0  0  0  0  0  0  0  0  0  0
 0  0  0  0  0  0  0  0  0  0  0  0  0  0  0  0  0  0  0  0  0  0  0  0  0